{
  "发": ["發", "髮"],
  "干": ["乾", "幹", "干"],
  "后": ["後", "后"],
  "面": ["麵", "面"],
  "只": ["只", "隻"],
  "空": ["空", "控"],
  "差": ["差", "岔"],
  "重": ["重", "種"],
  "行": ["行", "航", "型"],
  "当": ["當", "挡"],
  "系": ["系", "繫"],
  "划": ["劃", "划"],
  "兴": ["興", "兴"],
  "松": ["鬆", "松"],
  "蒙": ["蒙", "矇", "懞"],
  "征": ["徵", "征"],
  "斗": ["鬥", "斗"],
  "于": ["於", "于"],
  "妆": ["妝", "粧"],
  "呆": ["呆", "獃", "待"],
  "杰": ["傑", "杰"],
  "虱": ["蝨", "虱"]
}
